#####################################################################################
##                        ###                           ###                        ##
##    ######    #####     ###      ######    ######     ###    ######    ######    ##
##    ######    #####     ###      ######    ######     ###    ######    ######    ##
##    ######    #####     ###      ######    ######     ###    ######    ######    ##
##                                                                                 ##
##    ######    #####     ###      ################     ###    ######    ######    ##
##    ######    #####              ################            ######    ######    ##
##              ##############           ####          ##############              ##
##              ##############    ###    ####    ###   ##############              ##
##    ######    #####             ###    ####    ###           ######    ######    ##
##    ######    #####                                          ######    ######    ##
##                                  ################                               ##
###########     #####    ######     #              #     #####     #####    #########   
                #####    ######     #              #     #####     #####         
###########     #####    ######     #              #     #####     #####    #########
##                       ######     ################     #####                     ##
##    ############                                                 ############    ##
##    ############    #####         ################     #####     ############    ##
##            ####    #####               ####           #####     ####            ##
##########    ####                        ####                     ####    ##########
##########                  ###           ####           ###               ##########
##########      ########    ###                          ###    ########   ##########
##########      ########    ###     ################     ###    ########   ##########
##                          ###           ####           ###                       ##
##    #####      ##################       ####       ##################    #####   ##
##    #####      ##################       ####       ##################    #####   ##
##                                                                                 ##
#####################################################################################