#####################################################################################
## .......................###...........................###........................##
## .  ###### .  #####  .  ###   .  ######    ######  .  ### .  ###### .  ###### .  ##
## .  ###### .  #####  .  ###   .  ######    ######  .  ### .  ###### .  ###### .  ##
## .  ###### .  #####  .  ###   .  ######    ######  .  ### .  ###### .  ###### .  ##
##.................................................................................##
## .  ###### .  #####  .  ###      ################  .  ### .  ###### .  ###### .  ##
## .  ###### .  #####  .........   ################  ..........###### .  ###### .  ##
## .  ........  ############## ..........####......... ############## .  ...... .  ##
## .  ........  ############## .  ### .  #### .  ### . ############## .  ...... .  ##
## .  ###### .  #####...........  ### .  #### .  ### ............#### .  ###### .  ##
## .  ###### .  #####..........................................###### .  ###### .  ##
## .................................################...............................##
###########  .  ##### .  ######  .  #              #     #####     #####    #########
             .  ##### .  ######  .  #              #     #####     #####         
###########  .  ##### .  ######  .  #              #     #####     #####    #########
##................... .  ######  .  ################     #####                     ##
##    ############ ................................................############ .  ##
##    ############    #####         ################     #####     ############    ##
##            ####    #####               ####           #####     ####            ##
##########    ####                        ####                     ####    ##########
##########                  ###           ####           ###               ##########
##########      ########    ###                          ###    ########   ##########
##########      ########    ###     ################     ###    ########   ##########
##..........................###...........#### ..........###.......................##
##    #####      ##################       ####       ##################    #####   ##
##    #####      ##################       ####       ##################    #####   ##
##.................................................................................##
#####################################################################################