#####################################################################################
## .....................  ###   ..........*...........  ### .....................  ##
## .  ###### .  #####  .  ###   .  ######    ######  .  ### .  ###### .  ###### .  ##
## .  ###### .  #####  .  ###   .  ######    ######  .  ### .  ###### .  ###### .  ##
## .  ###### .  #####  .  ###   .  ######    ######  .  ### .  ###### .  ###### .  ##
## ...................................................................*..........  ##
## .  ###### .  #####  .  ###   .  ################  .  ### .  ###### .  ###### .  ##
## .  ###### .  #####  ..........  ################  ........  ###### .  ###### .  ##
## .  ........  ############## ........  #### ........ ############## .  ...... .  ##
## .  ........  ############## .  ### .  #### .  ### . ############## .  ...... .  ##
## .  ###### .  #####          .  ### .  #### .  ### .          ##### .  ###### .  ##
## .  ###### .  #####  .......................................  ##### .  ###### .  ##
## *..............................  ################  ...........................  ##
###########  .  ##### .  ######  .  #              #  .  #####  .  #####    #########
             .  ##### .  ######  .  #              #  .  #####  .  #####         
###########  .  ##### .  ######  .  #              #  .  #####  .  #####    #########
## .................. .  ######  .  ################  .  #####  .................  ##
## .  ############ .  ...........*...............................  ############ .  ##
## .  ############ .  #####         ################     #####  .  ############ .  ##
## ....... .  #### .  #####               ####           #####  .  ####  ........  ##
########## .  #### .....................  ####  ................*  ####  . ##########
########## ...............  ###  .     .  ####  .        ### .  ........ . ##########
########## .    ######## .  ###  .     ..........        ### .  ######## . ##########
########## .    ######## .  ###  .  ################     ### .  ######## . ##########
## .......................  ###  ......   ####   ........### ..................... ##
## .  #####  .   ##################   .   ####   .   ################## .  ##### . ##
## .  #####  .   ##################   .   ####   .   ################## .  ##### . ##
## ..........*.................................................................... ##
#####################################################################################